NO ./textures/north.xpm
SO ./textures/south.xpm  
WE ./textures/west.xpm
EA ./textures/east.xpm

F 50,100,200
C 200,200,150

111111111
100000001
101111101
100N00001
101010101
100000001
111111111
